rollno,name,cmarks,cppmarks,pymarks,total,percentage,grade
1,Kaushal,90,85,78,253,84.33333333333334,A
2,Anuj,75,88,92,255,85.0,A
3,Raj,82,79,85,246,82.0,A
4,Jenish,88,90,76,254,84.66666666666667,A
5,Savan,78,82,95,255,85.0,A
6,Aman,91,76,88,255,85.0,A
7,Karan,85,92,89,266,88.66666666666667,A
8,Jay,92,85,94,271,90.33333333333333,A+
9,Viru,76,78,92,246,82.0,A
10,Shiv,89,91,87,267,89.0,A
